1 4 2 2 2 2 2 2 2 2 2 2 2 2 2 2 2 2 2 2 2 2 2 5 1
6 0 0 0 0 0 0 0 0 0 0 0 0 0 0 0 0 0 0 0 0 0 0 0 6
3 0 0 0 0 0 0 0 0 0 0 0 0 0 0 0 0 0 0 0 0 0 0 0 3
3 0 0 1 4 2 2 2 2 5 1 10 10 10 1 4 2 2 2 2 5 1 0 0 3
3 0 0 6 0 0 10 0 0 0 0 0 0 0 0 0 0 0 0 0 0 6 0 0 3
3 0 0 3 0 0 10 0 0 0 0 0 0 0 0 0 0 0 0 0 0 3 0 0 3
3 0 0 7 0 0 1 0 0 0 0 0 0 0 0 0 0 0 0 0 0 7 0 0 3
3 0 0 1 0 0 6 0 0 0 0 0 10 0 0 0 0 0 0 0 0 1 0 0 3
3 0 0 10 0 0 3 0 0 0 0 0 0 0 10 0 0 0 0 0 0 10 0 0 3
3 0 0 10 0 0 7 0 0 0 0 0 0 0 0 0 0 0 0 0 0 10 0 0 3
3 0 0 10 0 0 1 2 2 2 2 2 2 2 2 2 2 2 1 0 0 10 0 0 3
3 0 0 1 0 0 0 0 0 0 0 0 0 0 0 0 0 0 6 0 0 1 0 0 3
3 0 0 6 0 0 0 0 10 0 0 0 0 0 0 0 0 0 7 0 0 6 0 0 3
3 0 0 3 0 0 0 0 0 0 10 0 0 0 0 0 0 0 1 0 0 3 0 0 3
3 0 0 3 0 0 0 0 10 0 0 0 0 0 0 0 0 0 10 0 0 3 0 0 3
3 0 0 7 0 0 0 0 0 0 0 0 0 0 0 0 0 0 10 0 0 7 0 0 3
3 0 0 1 4 2 2 2 2 5 1 10 10 10 1 4 2 2 2 2 5 1 0 0 3
3 0 0 0 0 0 0 0 0 0 0 0 0 0 0 0 0 0 0 0 0 0 0 0 3
7 0 0 0 0 0 0 0 0 0 0 0 0 0 0 0 0 0 0 0 0 0 0 0 7
1 4 2 2 2 2 2 2 2 2 2 2 2 2 2 2 2 2 2 2 2 2 2 5 1